Level 1
##################
#@...............#
# $###############
#  $ $ $ $ $ $ $ #
# $ $ $ $ $ $ $  #
#                #
##################

Level 2
###########
#  .......#
#  .......#
#  ########
#         #
# $$$$$$$ #
#         #
# $$$$$$$ #
#        @#
###########

Level 3
#######
#@$.#*#
#######

Level 4
  ###########
 ##     #  @#
###     #   #
# ##        #
#  #    #   #
###### ######
#    .$ #*##
#       ###
#    #####
#########

Level 5
#########
#  ### .#
#@$     #
#  ###  #
#########

Level 6
###########
#         #
#@  $.    #
### ### ###
### ### ###
### ### ###
### ### ###
###     ###
###########

Level 7
###########
#         #
#@  $     #
### ### ###
### ### ###
###.### ###
### ### ###
###     ###
###########

Level 8
    #####
    #   #
    #$  #
  ###   ##
  #      #
### # ## #   ######
#   # ## #####    #
#    @           .#
##### ### # ##    #
    #     #########
    #######

Level 9
    #####
    #   #
    #   #
  ###   ##
  #      #
### # ## #   ######
#   # ## #####    #
#        @$      .#
##### ### ####    #
    #     #########
    #######

Level 10
 ####
##  ####
#     .#
#      #
#   # ##
#   #  #### ####
#####$    ###  #
    #@ ##      #
   ###         #
   #    ##   ###
   #    ######
   ######

Level 11
########
#@$...*#
#  #####
# $  #
#  $ #
#    #
######

Level 12
        #######  
        #     #  
        #  #  #  
        # $$  #  
        ##   $#  
#########  @# ###
#....  ##  $    #
##.**   $ $  $  #
#..**  ##########
########

Level 13
###########
#@        #
#$#$#$#$#$#
# # # # # #
# # # # # #
# # # # # #
# # # # # #
# # # # # #
# # # # # #
# # # # # #
# # # # # #
# # # # # #
# # # # # #
# # # # # #
# # # # # #
# # # # # #
# # # # # #
# # # # # #
# # # # # #
#.#.#.#.#.#
###########

Level 14
#############
#@          #
#$$#$$#$$#$$#
#  #  #  #  #
#  #  #  #  #
#  #  #  #  #
#  #  #  #  #
#  #  #  #  #
#  #  #  #  #
#  #  #  #  #
#  #  #  #  #
#  #  #  #  #
#  #  #  #  #
#  #  #  #  #
#  #  #  #  #
#  #  #  #  #
#  #  #  #  #
#  #  #  #  #
#  #  #  #  #
#  #  #  #  #
#..#..#..#..#
#############

Level 15
#############
#@       #  #
##$#$$#$$#  #
#  #  #  #  #
#  #  #  #  #
#  #  #  #  #
#  #  #  #  #
#  #  #  #  #
#  #  #  #  #
#  #  #  #  #
# $# $# $#  #
#  #  #  #  #
#  #  #  #  #
#  #  #  #  #
#  #  #  #  #
#  #  #  #  #
#  #  #  #  #
#  #  #  #  #
#  #  #  #  #
#  #  #  #  #
#   ........#
#############

Level 16
###########
#  ##     #
# $   $ # #
#  ### ## #
## ###  # #
# $   $ # #
#   ##  # #
### ##### #
###$# .$. #
# .       #
# *# .#.@.#
#     #   #
###########

Level 17
###########
#  ##     #
#       #.#
#  ### ##.#
## ###  #.#
#       #.#
#   ##  #.#
### #####.#
### # $ $.#
# $       #
# $# $#$@$#
#     #   #
###########

Level 18 - star
#######
#   #.#
# $$#.###
# @   ..#
# $$# ###
#     #
#######

Level 19 - Huge
###############################
#@                            #
# $        $      $         $ #
#                             #
#                             #
#                             #
#                             #
#                             #
#                             #
#                             #
#                             #
#                             #
# $        $      $         $ #
#                             #
#            ....             #
#            ....             #
#            ....             #
#            ....             #
#                             #
# $        $      $         $ #
#                             #
#                             #
#                             #
#                             #
#                             #
#                             #
#                             #
#                             #
#                             #
# $        $      $         $ #
#                             #
###############################

Level 20 - tunnel deadlock
############
# .$     * #
#   #####  #
#     @    #
############

Level 21 - tunnel deadlock
#############
# .$.    $  #
#   #####   #
#     @     #
#############

Level 22 - non-tunnel deadlock
############
# .$  @  * #
#   #####  #
#          #
############

Level 23 - non-tunnel deadlock
############
#  $.   .$ #
#   #####  #
#     @    #
############

Level 24 - 2x3 deadlock
#########
#   @   #
#   $   #
#  #  . #
# . $#  #
#       #
#########

Level 25 - 2x3 deadlock
#########
#   @   #
#   $   #
# .  #  #
#  #$ . #
#       #
#########

Level 26 - non-2x3 deadlock
#########
#   @   #
#   $   #
#  #  . #
#  #$ . #
#       #
#########
